5
8
########
E      #
### ####
### ####
###S####
